1111111101
1000000001
1011011101
1000010001
1010011101
1000000001
1111111111