0000000110010000100000001000000000000000000000001100000000000000010000000010000010000000000000010000
0100000110000001000011100001000000000010100000000000000100000010000000000010000100000000010000000000
0000001000000000001101011100000000100110001000010001001001000100110000110000001100000010000000010000
0001011000100000011000111000000000001101000110000000010000100000111000000100000100100000000000100001
0000000100000100010000100000100100011100000000100010001000000110000011010100000000000010001100000001
0001000000000110000000000000000000000010010000110100001000000000001100000000010010010000010100100000
0000000000000010000000000010001000000000110010000000010011100000100000000101010011000000010000100100
0000000001010000001001000100001000010010000001000000101010010010000001000000000011100000000100010000
0000001000000010100000010000000001000000000000110000101110000010000101000010000001001001000000010000
1100010010010000010110001101000000010011001001000000000000000000101100000000000001000101000000100000
0010100001000010000000000000001000000001010000001100100010001000000000000000000010011001000111100001
0001000000000000100100000000001001000000000010100000000000100000000100001001010000000110000000000000
1100000010000010000111000000000010110100100001100010000000010001100100001010000010000101000100000000
1101001000010000000001000000000111000101100010101100001000000000010000000101100000000000010010010000
0000010110011100001000100000001000000001000000000100000101010100000000000001110001000010010001001010
0010000011110111000000000000000000000011001100100000100001010001101000011010010000101010100001000100
0011000000001100010011000001000001000101001000000010100000000101000010000101010000100010000011100001
0000100001000000000000000100000110001000001000000000001110000000001010101010000000100001010101000000
1000000001100000000000000010000101000000011010110000010000011000000000001111000001100010010000000000
0010011100000000000100001110010000000000000001010010001000100000000001100100001000010100001100100001
0001000010000010010100000000000110010000001000000010000000000010000011010001001000001010000000000001
0000000100000010000000000100010000000100000101000001001000001001101000000000010000000000000000000001
0101011000010110000110110000100000100000001101100100010101000100000000000101011011110000001000101000
0110000000000010000001010000010000100000100000000000000111000000110000110000001000010000010010000000
0000001100100011100000111100100000000000110010000000001010000000000000101000000000010000001011000001
1000010001000100100000000000000100101101100000001010000010000100101000010001100000100000101000000000
0100100010001100000000100000000001000010000001100011000001001010010001000000000000010011001000110010
0110001001000000000001010000010000000001000011100000000000000100000000001100000001000011010000000001
1100101100000010001000000000000100010000001110000011001000000100100000001100101010110010001000010100
0001001000100000000000100000010000000100000000001000010001101000000000100000000000000000100000100000
0010100001000000000000101000000000100100001100000010000100000110010000000000000000000100100001010000
0110000010000010001001100000100000000000001101000111000000000101100001000000000000000101001010010001
1010000100100000000000000000000011000000011000101000011001000000100000000000000000000000010000100000
0010101110101110000000000100000001000000000001010000010001001000000000000010000000001100000000010000
0001010000000100010000100000010100000100000000000000000000000100000001100000000010010101100100010000
0010000001000000010110000000000001000000100000000000001000100010000001110000000100000000010001101001
0001011000100000000001100001000110001000000000000001100000100011000000100000000110001000001001000010
1000010000010100000010000010000000000000001100011010000000000001000011010100100001000000001000001001
0100001000100100101000001100000001001000001000000101011000001100000010010100000000011000010000001000
0000110100001000101110000000000101001000000010000000001001101000000100001000000010000001000000000010
1001000000000000100000100001101001000001011000000100000000000001000100100000010000001000000001100000
0000000101110111000000000000001101001100011000000010010110100001000000000011000000000100000010001000
0000000000000000010100000000000000001100100000001000000000001101001001000001011000100001000000000000
0000000001110100000100111010001000000111000000000100010001101100011000000100100000000000110000000000
0000000000010000000000010011110000010000000100000000000000100000001001000100010000100011100000000010
0000001100111000100000000110010001000100001000000100010011000000001000110000010000000000001100000010
0000110100000000000000000000100000010010000001101110001000100100001000000001000001110100000000010010
1010000000000001000100000000001001010100100000001000001000000000000011010000000000011100000000000000
0000000100010100000010000010101001100001100000100100000000100110100001000010010000000000000010110010
0001000000000010000000000000000000000000000100000000000000001001000000100110000000000011000001000000
0010001110001110010000000000110010010100100010000000000000000100001000011001100000010000000000000000
0000000000100000010000001000100000000000000000000000010000000001000100000000000010000001010000010000
0000000010000100000010000100000000000000000000100000000000001000010001000110000101000000001010100100
0000001110010010000000000000110100001000000000010010100000000100000000000100000000000000001100001100
0100010011000001010000000000010110000001000100000000000000100011000001111000000000000100000001000010
0100110100000010001000000000000000101000000010010010000010010000000000000000000010010000001010011001
1001000000001000000000010101000000000110000000101100000010001000100100110100010000011100001000011010
1000010001100011010000010001000000000100100000010101000010100100000000000001000011000000100000000100
1100000000100000001101000000100000001100000000101000011000000000001001010000100010000001000010000000
1001000000000000000001000000000000000110000001000000000000000100001000000000000000100101010000000000
1000000010000000000000010101000000000000011100000100110000000010000000000000001000000000000010110000
0000000101010100100000000000000000010000001000000100001100000000000001000000000000100000100010101001
0000010011000001101001000000000000000000000001000010010000000000000100100111100010000000000010010001
0000000001110010100000000010011010010000010000001000001000000000010011000000101010000100010000010100
0000000000010101000001000100000000000010000010100000010001000010011101000000000000001001000100100000
0000010000011000000000000000100100010000010100000000011000010000000100000000100000000010100000100100
0010001000010000010000000110000000000000000001110010000000000000001000000100000000100000001000000000
1010000000000000000001000110000000100010010000000001001111000110000000010000000100000000000000001000
0000000000000001000000010010000001010000010001000000001000100000000001000010000100100000100000110010
0000001000001010000000000000101000100000010000001000000000000000000100000101000001001000000001000011
0000001000000000010100001001000000010000000000001000000000000010000000110001000001000101010000010000
1001000000100100000100000001000100000000001010000000000000100100000000000110010000001100000000001101
0000000110011000000010000000001000001000001000000000000001010001010000100000100000000100000000010100
0000001000000101001000101101000000101000010000000000000000100000000000000001000000000100010100010011
1000110000001000100010010000010000000111000000100000011000000000100000001100000100000000100110001000
0000010000110000010000100000000000010000001001000000000001000000100000000000000000001100000100100000
0000010000001100000010000000000010001000000000110000101000000001000010001000000100001001000011010000
0100000000100100010010001000000000000001001000100000010000100000010000100000100000101101100000010010
0000011000001000000000000000100011111000000101001001010001000000000010001000001010010000001001000001
0001001000000001000000000100010001001001000111000000000110001100001000000010100010000000110000000101
0000011000001001000000000000001100000000000001000000001010000000010101010000000000000100000010000001
0000000011010000000000000000000100000011100000000010001010000000000001010010000000000000011000001001
1000010000000010010000001000101000010000111000000100100010000000000100001110000001010000000010001010
0101011000000000000000000001000010000000000000010001010100000000000100000100100010000100000000110001
0001010000100010000001001110000000000001110100100000000000000000000000100110000000000101000000000000
1100000011001000000011001000000001000111100110000000001000000100000100000110101010010000000010000001
0000110110000000010000000000000000000000000101100000010000000000000000000000000001110000100000110000
0000000000100000000000100100000000100000000010100100000010001110010001000100010100000000100000100000
0001000000000000010000000010010000000000000000001001000010000110001000001010000001110000001000100000
0000001010000000000100001010000010000000000000010010001000000000100000000000000000000010000000010000
0000000001110001011000011000010000000000000100100000011000000100000010001010001000000110001000000000
0010000010000000000001100000001000000000110100000100000000100000100010000000000000000100000110000000
0000000010000000010001000000000000000000001001100100101000010101000000100000000000000000010011100100
0100011000000001001111101000000010010000100011010000100000000001000100000001010000001001000011000000
1000000000000100000110000000000100000010010001000001000010001001000000010100001100000000100100000100
0010100000000000011111100110001100001001000100000000000001000000010001100000000000000010000100001100
0100011000010010000100000000101100001000000100100000100000000100000000001001000001000010000000000001
1000000101000000000000000000100000000000000001000100011000000100001001000001000100001000000010000010
0000000110000100110000000000000001101001010001000000000001110010100100010000100100100001100110001110
0011000101000000000001000000000110000100000111000100100100011000000000000010000000000000000000000001
0001000110001001000000000010000000101100010001001100100110001000001011000000001010011000000000100100
0000000001110100000100100000000100000000001101000000000100010100000000001010000001000100010000010010
0100000000001000001000000100000001000000111000000010100000000000000001001001001000000100010100000000
0011001010010010001000010000001010011100000000000011011000010010001000000001000010000000000000001000
0100000010100000001100100000001101010000100100000000100101001000000000010000001010010000100000000000
0010000001000100001001000000000000010000000000000000000000000100001000001000100100000001000000010100
1000000000000100011010010000100000010000000000010000100000110111100100000100100010010000001000000010
0100100000001010010000000000000000011001000001010000001000000110000101101010000000000010001110010000
1000101001001010000000000010000100000000100010101000000000001000000001000011000011010001100010001001
1010000000100010010000000100100100010000000000000100000000010000000000000110001000011100000000000001
0000001001010000011000000000010000001001001000000000110001000000000000000000000100001010101100000000
0001100000000010100000000000100010000001011000100100001000011001000000010110110000000100000000001110
1000000000001000000010100100100000001000000000000100000100000100000010000001000000000000000000000011
1000001010000100100101010001000000100010100101100001110000010000101001110101010000000000000001010100
0000000110000000011000011000001010010100110000100000000000100011011000000110010001000001010100000110
0001000000000000011100110010010100000000000100000000100011001010010010000000000000010001000010000000
0110100000000110010000000000010000000001001111000000010000011100000000000010000010000000010000100000
0000101000111011000110100011000000000110000010110110100000000100000101001000000000000000000000000001
0010000000000000000100000000110000010010000010011000000000000010000100010000010000100000000001000010
0000000011000010000000001100000000000000100000100000000010001000000000000000000000001010000100001001